# Bu dosyada turkce karakter-phoneme gosterim eslenikleri yer alir. 
a=a
b=b
c=c
ç=C
d=d
e=e
f=f
g=g
ğ=G
h=h
ı=I
i=i
j=j
k=k
l=l
m=m
n=n
o=o
ö=O
p=p
r=r
s=s
ş=S
t=t
u=u
ü=U
v=v
y=y
z=z