# Bu dosyada mbrala standart karakter-phoneme gosterim eslenikleri yer alir.
a=a
b=b
c=dZ
ç=tS
d=d
e=e
f=f
g=g
ğ=G
h=h
ı=@
i=I
j=Z
k=k
l=l
m=m
n=n
o=o
ö=@_
p=p
r=r
s=s
ş=S
t=t
u=u
ü=y
v=v
y=j
z=z